15x15
S--------------
---------------
---------------
---------------
----WWWWW------
----WJWJW------
----WWWWW------
-----JWJ-------
----WWWWW------
---------------
---------------
-----------JJJJ
-----------J---
-----------J-WW
-----------J-WE
3x3
-SW
WJW
EW-
9x9
S--------
-WWWWWWWW
-W------J
-W-WWWWWW
-W-W-----
-W-W-WWWW
-W-W-W--J
-W-W-W-WW
JW-WJW-WE
2x7
E-
WW
-J
WW
JW
WW
JS